--nivel 1
############################################################
#.P........................................................#
#..........................................................#
#.........................M................................#
#.......###................................................#
#.......#.#................................................#
#.......#.#................................................#
#.......#.#................................................#
#.......###................................................#
#..........................................................#
#..........................................................#
#..........................................................#
#..........................................................#
#..........................................................#
#..........................................................#
#..........................................................#
#..........................................................#
#..........................................................#
#..........................................................#
#..........................................................#
#..........................................................#
#..........................................................#
#..........................................................#
#..........................................................#
#..........................................................#
#..........................................................#
#..........................................................#
#..........................................................#
#..........................................................#
#..........................................................#
#..........................................................#
#..........................................................#
#..........................................................#
#..........................................................#
#..........................................................#
#..........................................................#
#..........................................................#
#..........................................................#
#..........................................................#
#..........................................................#
#..........................................................#
#..........................................................#
#..........................................................#
#..........................................................#
#..........................................................#
#..........................................................#
#..........................................................#
#..........................................................#
#..........................................................#
#..........................................................#
#..........................................................#
#..........................................................#
#..........................................................#
#..........................................................#
#..........................................................#
#..........................................................#
#..........................................................#
#.........................................................E#
#.........................M................................#
############################################################
--nivel 2
############################################################
#P..M......................................................#
// ... (aqui irian las 60 filas del nivel 2)